WE ./wall3.png
SO ./wall2.png
NO ./wall.png
EA ./wall4.png




C 170,170,170
F 204,204,204

1111111111111111111111111111111111111
1000000000000000000000000000000000001
1000000000000000000000000000000000001
10000000000000000000000100000000000011111
1000000000000000000E000000000000000000001
10000000000000111100000000000000000011111
1111111111111111111111111111111111111